****************************************************************************
*           *           *                    *           *                 *
*  ******   *  *******  *  *  *************  *********   *  ****  *  ***   *
*  *        *  *        *  *  *           *              *  *  *  *  *     *
*  *  *******  *  *  *  *  *************  *  *************  *  *  **********
*  *  *           *  *  *              *     *                 *           *
*  *  *           ****  *  **       *  *  ****  ************************   *
*  *  *        *        *  *        *  *  *  *  *  *                       *
*  *  ****     *   ***  *  ******   *  *  *  *  *  *  *******************  *
*  *           *        *           *  *  *  *  *  *  *        *        *  *
*  *******************  *************  *  *  *  *  *  *  ***   *  ****  *  *
*                                      *     *  *  *  *  *     *  *  *  *  *
*  ****************  *************  *  *******  *  *  *  *******  *  *  *  *
*  *              *  *           *  *        *  *  *  *              *  *  *
*  *  **********  *  *  *******  *  ******   *  *  *  ****************  *  *
*  *  *        *  *  *  *     *  *  *        *  *  *                 *     *
*  *  ******   *  *  *  *  *  *  *  *  *******  *  ****************  *******
*  *                    *  *  *  *  *  *        *                 *        *
*  *************  *  *  *  *  *  *  *  *  *******  *************  ****  *  *
*                 *  *  *  *  *  *  *  *  *        *           *  *  *  *  *
*******************  *  *                    ****  *   ******  *  *  *  *  *
*                    *  *  *  *  *  *  *  *  *  *  *        *  *  *  *  *  *
*  *********   *******  *  *  *  *  *  *  *  *  *  *  *******  *  *  *  *  *
*  *           *     *  *  *     *  *  *  *     *  *  *        *     *  *  *
*  *************  *  ****  *******  *  *  ****  *  ****  ***   ****  *  *  *
*                 *  *                 *  *  *  *  *     *        *  *  *  *
*  ****************  *   ******   ***  *  *  *  *  *   ************  *  *  *
*  *     *           *        *     *  *  *     *                    *  *  *
*  ***   *  *******  *******************  *   ***  ****    **** ******  *  *
*        *  *     *  *                    *     *  *                    *  *
*******  *  *   ***  *  *************************  *  ********* *********  *
*     *  *  *     *  *  *           *              *  *  *                 *
*  *  *  *  *  *  *  *  *********   ***   *******  *  *  *  *** ************
*  *  *  *  *  *     *  *                 *     *  *  *  *  *           *  *
*  ****  *  **********  *  *  ***   *******   ***  *  *  *  *  *   ***  *  *
*     *  *                 *  *     *              *  *     *  *     *     *
*  *  *  *******************  **********   ***    **  ****  *******  *******
*  *  *  *     *                       *           *  *  *        *        *
*  *  *  *  *  *  *******************  ******* *****  *  *******  *  ****  *
*  *  *  *  *  *  *                 *                 *     *  *  *  *  *  *
*  ****  *  ****  *  ***  **************** ************  *  *  *  *  *  *  *
*        *     *  *  *                             *     *  *  *  *  *  *  *
*  *******  *  *  *  *  ****************  *******  *  *  *  *  *  *  *  *  *
*  *        *  *  *  *  *        *     *  *     *  *  *  *  *  *  *  *  *  *
*  **********  *  *  *  *  *  *  ***   *  *   ***  *  *  *  *  *  *  *  *  *
*           *  *  *  *  *  *  *        *  *           *  *     *  *  *  *  *
**********  *  *  *  *  ****  **********  *   ******  *  *******  *  *  *  *
*        *  *  *  *           *        *  *        *  *           *     *  *
*   ******  *  *  *************   ***  *  **********  *******   *********  *
*              *                    *  *                    *              *
****************************************************************************
